###########
#<-O-F#O-O#
#######|#|#
#O-<-O-O#<#
#|#|#######
#O#<-O-<#<#
#|#######|#
#O-O-<#O-<#
###########
